BANYULE : ['Abbotsford', 'Airport West', 'Albert Park', 'Alphington']
BRIMBANK : ['Altona', 'Altona North', 'Armadale', 'Ascot Vale']
DAREBIN : ['Ashburton', 'Ashwood', 'Avondale Heights', 'Balaclava']
HOBSONS BAY : ['Balwyn', 'Balwyn North', 'Bentleigh', 'Bentleigh East']
HUME : ['Box Hill', 'Braybrook', 'Brighton', 'Brighton East']
MARIBYRNONG : ['Brunswick', 'Brunswick West', 'Bulleen', 'Burwood']
MELBOURNE : ['Camberwell', 'Canterbury', 'Carlton North', 'Carnegie']
MELTON : ['Caulfield', 'Caulfield North', 'Caulfield South', 'Chadstone']
MOONEE VALLEY : ['Clifton Hill', 'Coburg', 'Coburg North', 'Collingwood']
MORELAND : ['Doncaster', 'Eaglemont', 'Elsternwick', 'Elwood']
NILLUMBIK : ['Essendon', 'Essendon North', 'Fairfield', 'Fitzroy']
WHITTLESEA : ['Fitzroy North', 'Flemington', 'Footscray', 'Glen Iris']
WYNDHAM : ['Glenroy', 'Gowanbrae', 'Hadfield', 'Hampton']
YARRA : ['Hampton East', 'Hawthorn', 'Heidelberg Heights', 'Heidelberg West']
BASS COAST : ['Hughesdale', 'Ivanhoe', 'Kealba', 'Keilor East']
SOUTH GIPPSLAND : ['Kensington', 'Kew', 'Kew East', 'Kooyong']
BAW BAW : ['Maidstone', 'Malvern', 'Malvern East', 'Maribyrnong']
BENALLA : ['Melbourne', 'Middle Park', 'Mont Albert', 'Moonee Ponds']
MANSFIELD : ['Moorabbin', 'Newport', 'Niddrie', 'North Melbourne']
MURRINDINDI : ['Northcote', 'Oak Park', 'Oakleigh South', 'Parkville']
BOROONDARA : ['Pascoe Vale', 'Port Melbourne', 'Prahran', 'Preston']
EAST GIPPSLAND : ['Reservoir', 'Richmond', 'Rosanna', 'Seddon']
GREATER SHEPPARTON : ['South Melbourne', 'South Yarra', 'Southbank', 'Spotswood']
KNOX : ['St Kilda', 'Strathmore', 'Sunshine', 'Sunshine North']
LATROBE : ['Sunshine West', 'Surrey Hills', 'Templestowe Lower', 'Thornbury']
MANNINGHAM : ['Toorak', 'Viewbank', 'Watsonia', 'West Melbourne']
MAROONDAH : ['Williamstown', 'Williamstown North', 'Windsor', 'Yallambie']
MITCHELL : ['Yarraville', 'Aberfeldie', 'Bellfield', 'Brunswick East']
STRATHBOGIE : ['Burnley', 'Campbellfield', 'Carlton', 'East Melbourne']
MONASH : ['Essendon West', 'Fawkner', 'Hawthorn East', 'Heidelberg']
ALPINE : ['Ivanhoe East', 'Jacana', 'Kingsbury', 'Kingsville']
MOIRA : ['Murrumbeena', 'Ormond', 'West Footscray', 'Albion']
WANGARATTA : ['Brooklyn', 'Glen Huntly', 'Oakleigh', 'Ripponlea']
WELLINGTON : ['Cremorne', 'Docklands', 'South Kingsville', 'Strathmore Heights']
WHITEHORSE : ['Travancore', 'Caulfield East', 'Seaholme', 'Keilor Park']
INDIGO : ['Gardenvale', 'Princes Hill', 'Bayswater', 'Bayswater North']
TOWONG : ['Beaumaris', 'Berwick', 'Boronia', 'Briar Hill']
WODONGA : ['Broadmeadows', 'Bundoora', 'Burnside Heights', 'Burwood East']
YARRA RANGES : ['Cairnlea', 'Caroline Springs', 'Cheltenham', 'Craigieburn']
CARDINIA : ['Cranbourne', 'Croydon', 'Dandenong', 'Dandenong North']
CASEY : ['Diamond Creek', 'Dingley Village', 'Doncaster East', 'Donvale']
FRANKSTON : ['Doreen', 'Eltham', 'Epping', 'Forest Hill']
BAYSIDE : ['Frankston', 'Frankston North', 'Frankston South', 'Gisborne']
GLEN EIRA : ['Gladstone Park', 'Greensborough', 'Hallam', 'Healesville']
GREATER DANDENONG : ['Highett', 'Hillside', 'Huntingdale', 'Keilor Downs']
KINGSTON : ['Keilor Lodge', 'Keysborough', 'Kings Park', 'Lalor']
MORNINGTON PENINSULA : ['Lower Plenty', 'Melton', 'Mernda', 'Mill Park']
PORT PHILLIP : ['Mitcham', 'Montmorency', 'Mordialloc', 'Mount Waverley']
STONNINGTON : ['Narre Warren', 'Nunawading', 'Oakleigh East', 'Parkdale']
BALLARAT : ['Point Cook', 'Ringwood East', 'Rockbank', 'Rowville']
PYRENEES : ['Sandringham', 'Seaford', 'Skye', 'South Morang']
GREATER BENDIGO : ['Springvale', 'St Albans', 'Sunbury', 'Tarneit']
CAMPASPE : ['Taylors Hill', 'Taylors Lakes', 'The Basin', 'Thomastown']
CENTRAL GOLDFIELDS : ['Truganina', 'Tullamarine', 'Vermont', 'Wantirna']
LODDON : ['Wantirna South', 'Werribee', 'Westmeadows', 'Williams Landing']
GREATER GEELONG : ['Wollert', 'Wyndham Vale', 'Black Rock', 'Blackburn']
QUEENSCLIFFE : ['Blackburn North', 'Bonbeach', 'Carrum', 'Chelsea']
HINDMARSH : ['Clayton', 'Doveton', 'Ferntree Gully', 'Glen Waverley']
HORSHAM : ['Greenvale', 'Heathmont', 'Hoppers Crossing', 'McKinnon']
WEST WIMMERA : ['Melton South', 'Melton West', 'Mentone', 'Mooroolbark']
MACEDON RANGES : ['Mulgrave', 'Ringwood', 'Roxburgh Park', 'Seabrook']
MOUNT ALEXANDER : ['Templestowe', 'Vermont South', 'Warrandyte', 'Watsonia North']
MILDURA : ['Wheelers Hill', 'Altona Meadows', 'Blackburn South', 'Carrum Downs']
GOLDEN PLAINS : ['Clayton South', 'Croydon North', 'Langwarrin', 'Noble Park']
HEPBURN : ['Notting Hill', 'Ringwood North', 'Sydenham', 'Albanvale']
MOORABOOL : ['Beaconsfield Upper', 'Chelsea Heights', 'Dallas', 'Deer Park']
ARARAT : ['Eltham North', 'Keilor', 'Meadow Heights', 'Mount Evelyn']
NORTHERN GRAMPIANS : ['North Warrandyte', 'Pakenham', 'Riddells Creek', 'Sandhurst']
YARRIAMBIACK : ['Scoresby', 'Silvan', 'Aspendale', 'Chirnside Park']
GLENELG : ['Croydon Hills', 'Croydon South', 'Derrimut', 'Diggers Rest']
SOUTHERN GRAMPIANS : ['Edithvale', 'Hampton Park', 'Knoxfield', 'St Helena']
COLAC-OTWAY : ['Upwey', 'Bacchus Marsh', 'Coolaroo', 'Cranbourne North']
SURF COAST : ['Kilsyth', 'Montrose', 'Aspendale Gardens', 'Bullengarook']
BULOKE : ['Clarinda', 'Deepdene', 'Delahey', 'Hurstbridge']
GANNAWARRA : ['Kurunjang', 'Wonga Park', 'Endeavour Hills', 'Officer']
SWAN HILL : ['Waterways', 'Ardeer', 'Beaconsfield', 'Springvale South']
CORANGAMITE : ['Yarra Glen', 'Brookfield', 'Emerald', 'Whittlesea']
MOYNE : ['Burnside', 'Attwood', 'Wallan', 'New Gisborne']
WARRNAMBOOL : ['Plumpton', 'Monbulk']
